####################
#S.................#
#.################.#
#..................#
#.################.#
#.......#..........#
#######.#.##########
#.......#..........#
#.################.#
#..................#
#.################.#
#..................#
#.################.#
#.................E#
####################