####################
#S#...#...#...#...E#
#.#.#.#.#.#.#.#.####
#.#.#.#.#.#.#.#....#
#...#...#...#.#.##.#
###########.#.#.#..#
#...........#.#.#.##
#.###########.#.#..#
#.............#....#
#.#############.####
#.#.............#..#
#.#.###########.#.##
#.#.#.........#.#..#
#...#.........#....#
####################