####################
#S..#..............#
###.###.##########.#
#...#...#........#.#
#.###.###.######.#.#
#.#.......#......#.#
#.#.#######.####.#.#
#.#.#.......#....#.#
#.#.###.#####.####.#
#.#...#..........#.#
#.###.##########.#.#
#...#............#.#
#.###.############.#
#.................E#
####################