####################
#S.................#
#.#######.#######..#
#.#.....#.#.....#..#
#.#.###.#.#.###.#..#
#.#.#...#.#.#...#..#
#.#.#####.#####.#..#
#..................#
#######.####.#######
#.......#E.#.......#
#.#######..#######.#
#.#..............#.#
#.#.############.#.#
#..................#
####################