####################
#S#.......#........#
#.#.#####.#.######.#
#.#.#...#.#.#....#.#
#.#.#.#.#.#.#.##.#.#
#...#.#.#...#.#..#.#
#####.#.#####.#.##.#
#.....#.......#....#
#.###########.####.#
#.#.........#....#.#
#.#.#######.####.#.#
#.#.#.....#......#.#
#.#.#.###.########.#
#.....#...........E#
####################